007000000000000000-
007100000000000000-
007000000000000000-
007100001000000000-
007001566400000000-
007000700700000700-
007101700710101700-
003666200366666200-
000000000000000000-
000000000000000000