000000000000000000-
566400000005640000-
700000000000000000-
700000000000000000-
700000000000000000-
300000000000000000-
000000000000000000-
000000000000000000-
000000066666600000-
000000000000000000